788888888888888888888888888888888888888888888888888888888888888888888888888888889
4qwwwOwwwwwwwwwwwwwwwwwwwwwwwwwOwwwwwwwwwwwwwwwwwwwwwwwwwwwwwwwwOwwwwwwwwwwwwwwe6
4asssOsssskkkkkkkkssyssskkkksssOsssyysssssskkkkkkkkkkkkkksssssssOssssssssssssssd6
4zxxxOxxxxllllllllxxhxxxllllxxxOxxxhhxxxxxxllllllllllllllxxxxxxxwxxxxxxxxxxxxxxc6
4..P.O......................I.bO......................;.........s...............6
4....O........................nO................rrt.............x...............6
4....O........................mO................ffg.............................6
4....O.........................O................................................6
4....O.........................O....................O...........................6
4....O.........................O....................O...........O...............6
4....OOOOOOOOOO...OOOOOOOOOOOOOOOOO...OOOOOOOOOOOOOOOOOOOOOOOOOOOOOOOOOOOO...OOO6
4....qwwwwwwwwe...qwwwwwwwwwwwwwwwe...qwwwweOqwwwwwwwwwwwwwwwwwwwwwwwwwwwe...qwe6
4....assssssssd...asssssssssssssssd...assssdOasssssssssssssssssssssssssssd...asd6
4....zxxxxxxxxc...zxxxxxxxxxxxxxxxc...zxxxxcOzxxxxxxxxxxxxxxxxxxxxxxxxxxxc...zxc6
4...........................................O.[.................................6
4...........................................O...................................6
4...........................................O.................O.................6
4.......O...........O.......................O.................O.................6
4.......L...........O.......................O.................L.................6
4...................O.......................O...................................6
4...................O..:....................O............]......................6
122222222222222222222222222222222222222222222222222222222222222222222222222222223